50 50
>0 deep_ocean
>1 shallow_ocean
>2 plain
>3 hill
>4 mountain
>5 desert
>6 jungle
>7 forest
>8 peak
>9 grassland
0 0 0 0 6 6 0 0 0 0 0 1 7 6 6 3 3 7 2 2 5 9 2 2 0 0 0 0 0 0 0 2 2 2 7 7 7 7 6 6 7 7 2 2 2 2 2 1 0 0 /
0 0 0 0 7 7 1 0 0 0 0 0 7 6 6 3 3 7 7 2 2 2 2 1 0 0 0 0 0 0 0 2 2 2 2 2 7 7 7 7 7 7 2 2 2 2 2 1 0 0 /
0 0 0 7 7 7 7 7 0 0 0 0 0 7 6 6 3 6 6 7 7 7 1 0 0 0 0 0 0 0 1 1 2 2 2 2 2 7 7 7 7 7 2 2 2 2 7 1 0 0 /
1 1 7 7 7 7 7 7 0 0 0 0 0 7 7 6 6 6 6 6 7 1 1 0 0 0 0 0 0 1 1 7 2 2 9 2 2 7 7 7 7 7 2 2 2 7 7 0 0 0 /
7 7 2 2 7 7 2 2 2 0 0 1 0 2 7 6 6 6 6 6 1 1 1 1 0 0 0 0 0 6 6 7 7 2 1 9 2 2 7 7 7 7 7 7 1 0 0 0 0 0 /
7 2 2 2 2 7 2 2 2 0 0 1 0 1 2 6 6 6 6 1 1 1 1 1 0 0 0 0 1 6 6 7 7 2 5 9 2 2 7 7 7 7 7 1 0 0 0 0 0 0 /
7 7 7 7 7 7 7 7 2 0 0 0 0 0 1 7 6 6 6 6 1 1 0 0 0 0 0 0 1 6 6 6 7 2 9 9 9 2 7 7 6 6 0 0 0 0 0 0 0 0 /
7 7 7 7 7 7 7 7 2 0 0 0 0 0 0 7 6 6 6 7 1 0 0 0 0 0 0 0 1 6 6 6 7 2 9 9 5 9 2 7 6 6 0 0 0 0 0 0 0 0 /
2 7 7 7 7 7 7 7 7 0 0 0 0 0 0 7 7 7 7 7 0 0 0 0 0 0 0 1 7 6 6 6 6 7 2 2 9 9 2 2 7 0 0 0 0 0 0 0 0 0 /
2 2 7 7 7 1 1 1 0 0 0 0 0 0 0 7 7 7 2 2 0 0 0 0 0 0 0 2 7 6 6 6 6 7 7 2 9 9 9 2 1 0 0 0 0 0 0 0 0 0 /
2 2 2 7 1 0 0 0 0 0 0 0 0 0 0 7 7 2 2 2 0 0 0 0 0 0 0 2 2 7 6 6 6 6 7 7 2 9 9 1 0 0 0 0 0 0 0 0 0 1 /
2 2 2 2 0 0 0 0 0 0 0 0 0 0 0 2 2 2 2 2 0 0 0 0 0 5 5 5 9 7 7 6 6 6 3 7 2 2 0 0 0 0 0 1 1 0 0 0 0 2 /
2 2 2 2 0 0 0 0 0 0 0 0 0 0 0 2 2 2 2 2 0 0 0 0 1 5 5 5 9 2 7 6 6 6 6 7 7 2 0 0 0 0 0 7 7 1 0 0 0 2 /
7 7 2 0 0 0 0 0 0 7 2 2 1 0 0 9 9 2 2 2 0 0 1 1 9 9 9 5 9 2 7 7 6 6 6 7 7 7 1 1 1 1 7 7 7 7 1 0 0 5 /
1 1 1 0 0 0 0 0 0 7 2 2 9 1 0 9 2 2 2 2 0 0 1 9 9 9 9 9 9 1 1 7 6 6 6 7 7 7 7 1 7 7 7 7 7 7 1 0 1 5 /
0 0 0 0 0 0 0 0 1 7 7 2 2 2 2 2 7 7 2 2 1 0 1 1 9 2 2 2 2 2 7 7 7 7 7 7 1 1 1 1 7 6 6 6 7 7 2 0 1 5 /
0 0 0 0 0 0 0 0 6 6 7 7 7 2 2 7 7 7 7 2 1 0 1 1 9 2 2 2 2 2 7 7 7 7 7 1 0 0 1 1 6 6 6 6 6 7 2 0 1 9 /
0 0 0 0 0 0 0 0 6 6 6 7 7 7 7 7 7 7 7 2 1 0 1 1 1 2 2 2 2 2 2 2 2 2 2 0 0 0 0 0 7 6 6 6 6 7 2 9 1 9 /
1 1 0 0 0 0 1 6 6 6 6 1 1 1 1 6 6 7 7 7 1 0 0 1 0 2 2 2 2 1 0 1 1 1 1 0 0 0 0 0 0 6 6 6 6 7 2 9 5 9 /
1 1 0 0 0 0 1 6 6 6 6 0 0 0 0 6 6 7 7 2 1 0 0 0 0 1 2 2 2 0 0 1 1 9 9 2 0 0 0 0 0 0 1 6 6 7 2 9 9 9 /
2 1 0 0 0 0 0 7 6 6 1 0 0 0 0 6 6 7 7 2 0 0 0 0 0 0 0 0 0 0 0 1 9 2 2 2 7 7 0 0 0 0 0 0 0 1 7 2 2 3 /
1 0 0 0 0 0 0 1 6 6 1 0 0 0 0 6 6 7 7 1 0 0 0 0 0 0 0 0 0 0 0 1 2 2 7 7 7 7 0 0 0 0 0 0 0 0 1 2 2 3 /
0 0 0 0 0 0 0 0 1 6 6 6 6 6 6 6 6 6 0 0 0 0 0 0 0 0 0 0 0 0 0 1 7 7 6 6 6 6 0 0 0 0 0 0 0 0 0 7 7 3 /
0 0 0 0 0 0 0 0 1 6 6 6 6 6 6 6 6 6 0 0 0 0 0 0 0 0 0 0 0 0 0 1 6 6 6 6 6 6 0 0 0 0 0 0 0 0 0 7 7 7 /
0 0 0 0 0 0 0 0 1 6 6 6 6 6 6 6 6 6 7 0 0 0 0 0 0 0 0 0 0 0 0 0 0 1 6 6 6 1 0 0 0 0 0 0 0 0 0 1 7 7 /
0 0 0 0 0 0 0 0 0 6 6 6 6 6 6 6 6 6 7 7 0 0 0 0 0 0 0 0 0 0 0 0 0 0 0 0 0 0 0 0 0 0 0 0 0 0 0 0 6 6 /
0 0 0 0 0 0 0 0 1 6 6 6 6 6 6 6 6 7 7 7 1 1 1 1 1 0 0 0 0 0 0 0 0 0 0 0 1 1 0 0 0 0 0 0 0 0 0 0 1 7 /
1 0 0 0 0 0 0 0 6 6 6 6 6 6 6 6 7 7 2 2 2 2 2 2 1 0 0 0 0 0 0 0 0 0 0 0 2 2 0 0 0 0 0 0 0 0 0 0 0 0 /
7 1 0 0 0 0 0 1 7 7 7 7 7 6 6 7 7 7 2 2 2 2 2 2 1 0 0 0 0 0 0 0 0 0 0 0 2 2 1 0 0 0 0 0 0 0 0 0 0 0 /
2 1 1 1 7 7 7 2 2 2 2 7 7 7 6 7 1 2 5 5 5 5 5 9 1 0 0 0 0 0 0 0 0 0 9 9 2 2 2 1 0 0 0 0 0 1 0 0 0 0 /
2 7 1 1 7 7 2 2 2 2 2 2 7 7 6 7 0 1 5 5 5 5 5 9 1 0 0 0 0 0 0 0 0 1 9 2 2 2 2 1 0 0 0 0 0 1 0 0 0 0 /
2 2 1 1 2 2 1 0 0 0 2 2 7 7 6 1 0 1 5 5 5 5 5 9 2 2 7 7 7 0 0 0 0 2 2 2 7 7 2 2 2 2 2 1 1 0 0 1 2 2 /
2 2 1 1 1 1 0 0 0 0 0 2 2 7 6 1 0 1 5 5 5 5 9 9 2 7 7 7 7 1 0 0 0 2 2 7 7 7 7 2 2 2 2 2 2 0 1 2 2 2 /
2 2 0 0 0 0 0 0 0 0 0 0 1 6 6 7 7 2 9 5 5 9 2 2 7 7 7 7 2 2 2 2 2 2 7 7 7 7 2 2 2 2 1 1 1 1 1 2 2 2 /
7 2 1 1 1 0 0 0 0 0 0 0 0 6 6 7 7 2 9 2 2 2 7 7 7 7 7 7 2 2 2 2 2 2 4 3 7 7 2 9 1 0 0 0 0 7 2 2 2 7 /
2 2 1 1 1 1 0 0 0 0 0 0 0 6 6 7 7 2 2 2 2 2 7 7 7 7 7 7 7 2 2 2 2 3 4 3 7 2 9 9 0 0 0 0 0 1 2 2 2 7 /
2 9 5 5 1 1 0 0 0 0 0 0 0 7 7 3 4 2 2 2 2 2 7 7 7 6 1 1 7 2 2 7 7 4 8 4 2 2 5 1 0 0 0 0 0 0 1 2 2 1 /
2 9 5 5 1 1 0 0 0 0 0 0 0 7 7 3 3 2 2 2 2 2 7 7 7 6 1 1 1 7 2 7 7 3 4 3 2 2 5 5 0 0 0 0 0 0 1 2 2 1 /
9 5 5 5 5 5 5 9 9 1 2 2 2 2 2 2 2 2 2 2 2 2 2 7 7 6 6 1 0 0 0 7 7 7 7 7 2 2 9 9 1 0 0 0 0 1 2 2 2 0 /
5 5 5 5 5 5 5 5 5 5 9 9 2 2 2 2 2 2 2 2 9 2 2 7 7 6 7 1 0 0 0 7 7 7 7 7 2 2 2 2 2 1 1 1 1 9 2 2 2 0 /
9 5 5 5 5 9 9 9 9 5 9 9 9 9 9 2 1 2 2 2 2 2 7 7 7 7 7 2 2 0 0 1 7 7 7 7 2 2 2 2 2 2 2 5 9 9 9 2 2 1 /
9 5 5 5 9 9 2 2 9 5 5 9 9 5 5 0 0 0 1 2 2 2 7 7 7 3 2 2 2 0 0 0 0 7 7 7 2 2 2 2 2 2 2 5 5 9 9 2 2 5 /
2 2 9 9 2 2 7 7 2 2 2 2 2 1 0 0 0 0 0 1 7 7 7 7 7 2 2 2 2 0 0 0 0 2 2 2 2 2 2 2 2 2 2 5 5 5 5 9 9 5 /
0 0 2 2 7 7 7 6 7 1 1 1 1 0 0 0 0 0 0 0 7 7 7 7 2 2 2 2 1 0 0 0 0 2 2 2 4 4 7 7 2 2 2 5 5 5 5 5 5 5 /
0 0 1 7 7 7 6 6 6 0 0 0 0 0 0 0 0 0 0 0 0 1 7 7 2 2 2 0 0 0 0 0 0 1 2 2 3 7 7 7 2 2 2 9 5 5 5 5 5 5 /
0 0 0 0 1 1 1 1 0 0 0 0 0 0 0 0 0 0 0 0 0 0 0 0 0 0 0 0 0 0 0 0 0 0 2 2 7 7 7 7 7 0 2 2 9 5 5 5 5 1 /
1 0 0 0 0 0 0 0 0 0 0 0 0 0 0 0 0 0 0 0 0 0 0 0 0 0 0 0 0 0 0 0 0 0 1 7 7 7 7 7 0 0 1 2 9 5 5 5 1 1 /
6 6 1 0 0 0 0 0 0 0 0 0 0 0 0 0 0 0 0 0 0 0 0 0 0 0 0 0 0 0 0 0 0 0 0 0 7 1 0 0 0 0 0 0 0 0 0 1 1 2 /
6 6 1 0 0 0 0 0 0 0 0 0 0 0 0 0 0 0 0 0 0 0 0 0 0 0 0 0 0 0 0 0 0 0 0 0 0 0 0 0 0 0 0 0 0 0 0 1 1 7 /
6 1 0 0 0 0 0 0 0 0 0 0 0 0 1 7 7 1 0 0 0 0 0 0 0 0 0 0 0 0 0 0 0 0 0 0 0 0 0 0 0 0 0 0 0 0 0 0 1 6 /
